##################################
#                                #
#                                #
# #################   ############
#                                #
#                                #
#     ####  #########            #
#        #  #                    #
#        #  #########            #
#                                #
#                                #
##################################