###############################
#                             #
#                             #
# #################   #########
#                             #
#                             #
#     ####  #########         #
#        #  #                 #
#        #  #########         #
#                             #
#                             #
###############################