#############################
#.                          #
#           .              .#
#.#################  .#######
#                          .#
#        .                  #
#    .####  #########       #
#       .# .#...            #
#        #  #########.      #
#       .        .          #
#.                         .#
#############################