#############################
#.                          #
#                          .#
#.#################  .#######
#                           #
#        .                  #
#     ####  #########       #
#       .# .#...            #
#        #  #########       #
#                .          #
#.                          #
#############################